.....................
..............X......
.....X...XXX.X.......
.....X......X........
.....X.....X.........
.....X....X..........
.....X....X..........
.....X....X..........
.......XXXX..........
.........XXXXXXXX....
.....X...X...........
.....X...XX..........
.....X....X..........
.....X.........X.....
.....X.........X.....
.....XXXXXXXXXXX.....
...............X.....
...............X.....
.....................
.....................
.....................